35
*  * **     * * *** ***  *  *  * **
   **** * **** *  * * * * *** * ***
*** * * **    ** ***   *   ***  ** 
 * * ** * *  * * *  *  * *        *
* ** *     ***        *** * *****  
 *  * *    * *     ***** *     * **
 * * *  * * *   *    *   **       *
 **** *   * **     **** ********  *
***  *** *   *  **   ** * ***** ***
 * * *   ***     *****  ****   ****
      ** ***** *** *     * ** ***  
   ***** ***  *  *****    ****** * 
** ** ***  *   ** ** *******  *  * 
 **  * * ** **  **  ** **  *  *  **
  *  *  * *  * ** ** ** *     ** * 
*   ** **  ***  * **** *  *  *   * 
 *** *  ****** **   *   **  **   **
**   *  *** * ** **      * **   * *
*  *** * * * **   ****   ****  *  *
**   * * ****      **  ***      *  
** *          * *  *  **   *  *** *
  * *** * * * *      ***   *    *  
* *    *** ****** **  **     *  * *
  *** * *   ** ** *** *   **** * **
** ****     **   *  *    **  ***   
* **  * * * **    *** * **  * ** **
  * * *  * * **   *   *    ** * ** 
*  ***  *****  * **  *  *   * ** * 
*  * ***     ***   *** *****  *  * 
*****  ****   **  **** *  **  **  *
***** ***  ** *   * * *  * * * ****
 **** * *  *    *   * ** ****** *  
    * *  *   *  * * ** ** ** * ** *
* *    **      *  ** *    ****** **
          * *** **   ***   *  * ***
